1111111111111111111111
1000000000110000000001
1011010110110110110101
1011010110110110110101
1000000000000000000001
1000000000EP0000000001
1000000000000000000001
1000000000000000000001
1011010110110110110101
1011010110110110110101
1000000000110000000C01
1111111111111111111111
