1111111111111111111111
1CCCCCCCCC11CCCCCCCCC1
1C11C1C11C11C11C11C1C1
1C11C1C11C11C11C11C1C1
1CCCCCCCCCCCCCCCCCCCC1
1000000000EP0000000001
1000000000000000000001
1CCCCCCCCCCCCCCCCCCCC1
1C11C1C11C11C11C11C1C1
1C11C1C11C11C11C11C1C1
1CCCCCCCCC11CCCCCCCCC1
1111111111111111111111
