111111111111111111
1CC000001100000CC1
100000001100000001
100000001100000001
111111100001111111
100000001100000001
100000001100000001
1CC00000110000E0P1
111111111111111111
