111111111111111111
100000001000000001
100000001000000001
100000001000000001
111111110001111111
100000001000000001
100000001000000001
10000000100000ECP1
111111111111111111
