1111111111
1000001111
100000PEC1
1111111111
