111111111111
1000P0000001
100000000001
100C00000001
100000000E01
111111111111
