1111111111
110111ECP1
1110100001
1111111111
