1111111111111111111
1000000000000000001
1000000011100001111
1000011111110000001
1100010001111000111
1111111111111011111
