111111111111
1000P0000001
100000C00E01
111111111111
