1111111111111111111
1000000000000000001
1000000011100000001
1000011111110000001
110001000111100000
1111111111111111111
