1111111111
100000ECP1
1000000001
1111111111
