1111111111
100000ECP1
1111111111
